
  	R  542   563

	NO ./pics/blue.xpm

 SO ./pics/brick.xpm

  WE ./pics/wood.xpm 

   EA ./pics/grey.xpm	

S ./pics/pillar.xpm   
	F   220, 100,	0

 C 0, 235,	235



  111
 11011  111
1100011 121
1002001 111
1100011
 11011    111
  111    1101
     111110011
    11211000011
   1100000N00011
    11100000011
      11100011
        11111
         111
          1